CropsId	Unnamed: 1	SeedId	StageTime1	StageTime2	StageTime3	StageTime4	RecoverTime	Quantity	StealQuantity	ProductionId	CanHarvestNum
作物Id	备注	种子ItemId	第一阶段时间（时间单位s）	第二阶段时间（时间单位s）	第三阶段时间（时间单位s）	第四阶段时间（时间单位s）	被采摘后恢复完整状态时间（时间单位s）	产量范围（3#5）	偷取范围（1#2）	产物ItemId物品	可收割次数
1261	小麦	957	312	0	0	0	0	1#2	1#2	2298	1
1269	马铃薯	965	372	0	0	0	0	1#2	1#2	648	1
1262	玉米	958	438	0	0	0	0	1#2	1#2	2295	1
1263	胡萝卜	959	498	0	0	0	0	1#2	1#2	647	1
1265	棉花	961	564	0	0	0	0	1#2	1#2	2299	1
1267	番茄	963	660	0	0	0	0	1#2	1#2	2297	1
1266	草莓	962	732	0	0	0	0	1#2	1#2	2296	1
1272	蚕丝	968	810	0	0	0	0	1#2	1#2	2300	1
